000000001110000
110000001011110
010101111010010
110101000010010
100111000011110
111101000000000
000001001110000
011101001010000
000111001110000
000010000010000
000010001110000
000010001000000
111110001000111
100001111111100
111111000001110
