000111001110000
110001001011110
010101111010010
110101000010010
100111011111110
111101000000100
000001001110110
011101001010010
000111001110010
010010000010110
011110101110000
000010101000000
111110101000111
100001111111100
111111000001110
